11111111
10001001
10010001
10110001
11100001

FFFFFFFF
F000F00F
F00F000F
F0FF000F
FFF0000F
